00000000000000000000000000000000
00000000000000000000000000000000
00000000000000000000000000000000
10000000000000400000100038000001
10300000000000400000144111100001
11104111000000400000004000000001
10004000000000400030004000800001
10004008500030400000004000100001
10034001100411100111104800000001
10411000000400000000000000000001
10411000000400000000000000000001
10444400000400000000030400000001
10000400000400000000111444000001
10000400000000000008000004000001
10000440000000000001000004000001
10000040003000000000000004000001
10000040011114000000000004000001
10000840000004000800000004500001
10000111100004000100000411111001
10000000000004000000000400000001
10000000000004000000000400840001
10000000000001110000000400140001
12000700000003000000000400146801
11111111111111111111111111111111