10000000000000000000000000000001
10000700000000000000000000003061
10001111400000000000000000411111
11880000400000000000000000400001
11110000400110000000000000400001
10000000400000000004111111400001
10000000400000000004000000000001
10000000400000000004000000000051
10000000400000411111000000000111
10500000400000400000000000001111
16000000411100400000000000011111
11100000000000400000000000000001
10000000000000400000000000000001
10300900000000400000000000030001
11111100000000400000000111111111
10001110000000400000000000111101
10000000000011111400000000000001
10300000000000000400000000030501
11110000000000000400000011111111
10000000000000000400000000000001
10000000000002000400000000000001
10000000000500000400300000000001
10000000111111111111111100000001
10000000000000000000000000000001

00000000000000000000000000000000
00000000000002000000000000000000
00000000111111111111111100000000
00000000000000000000000000000000