00000000000000000000000000000000
00000700000000000000000000003060
00001111001100000000000000111110
11000001111110000000000011110001
11110001011000000000000111000001
00000000000000000000111100000001
00000000000000000000000000000000
00000000000000000040000000000050
00000000000000011111000000000111
00500000050000000000000000001111

06000000000000000000000000011111
11100000000000000000000000000000
00000000000000000000000000000000
00300000000000000000000000030000
11111100000000000000000111111111
00001110000000300000000000111101
00000000000011111000000000000000
00300000000000000000000000030400
11110000000000000000000011111111
00000000000000000000000000000000

00000000000000000000000000000000
00000000000002000000000000000000
00000000111111111111111100000000
00000000000000000000000000000000