10000000000000000000000000000001
10000000000000000000000000000001
10000000000000000000000000000001
10000000000000009000000000000001
10080300000000001140000078083001
10411111000000000040000011111401
10400000050800000040808000000401
10400000111110000041111100000401
10400000000000000000000000000401
10400000000000000000000000000401
10400000000000000000000000000401
10400000000000000000000000000401
10400000000000000000000000000401
10400000605030000000000000000401
10400000111114000000000000000401
10400000000004000000000000000401
10400000000004000000000000000401
10400000000004000000000000000401
10400000000004000000000000000401
10400000000004000000000000000401
10400000000004000000000000000401
10400000000004000000000000000401
12400030080004008000008000000401
11111111111111111111111111111111