10000000000000000000000000000001
10000000000000000000000000000001
10000730000000000000000000003881
10801111400000000000000000411111
10800000400110000000000000400001
11100000400000000004111111400001
10000000400000000004000000000001
10000000400000000004000000000051
10000000400000411111000000000111
10500000408000400000000000081111
16000000411110400000000000011111
11100000000000400000000000000001
10000000000000400000000000000001
10300000000000400000000000030001
11111190000000400000000111110001
10001110000000400000000000110001
10000000000000400400000000000001
10000000000011110400000080030501
11110000000000000400000011111111
10000000000000000400000000000001
10000000000000000400000000000001
10000000020500000400300000000001
10000004111111111111111140000001
11111111111111111111111111111111