00000000000000000000000000000000
00000000000000000000000000000000
00000000000000000000000000000000
00000000000000009000000000000000
00080300000000001140000078083000
00411111000000000040000011111400
00400000050800000040808000000400
00400000111110000041111100000400
00400000000000000000000000000400
00400000000000000000000000000400
00400000000000000000000000000400
00400000000000000000000000000400
00400000000000000000000000000400
00400000605030000000000000000400
00400000111114000000000000000400
00400000000004000000000000000400
00400000000004000000000000000400
00400000000004000000000000000400
00400000000004000000000000000400
00400000000004000000000000000400
00400000000004000000000000000400
00400000000004000000000000000400
02400030080004008000008000000400
11111111111111111111111111111111