10000000000000000000000000000001
10000000000000000000000000000001
10400000000000000000000000000001
10411111111111111111111111000001
10400000000000000000000000000001
10400000000000000000003000111111
10400000000000000000111111000001
10400000000000000000300000000001
10400000000000000011111100000001
10400000000000000000000000000001
10400000000000001111110000000001
10400000000000030000008000000001
10400000000001111110008000000001
10400000000003000000008000000001
10400000000111111000008050000001
10400000000300000800008000000001
10400000011111100800008000000001
10400000030000000800008090000001
10400001111110060800008000000001
10400000300008000800008000000001
10400111111008000800008000000001
10411111100008000800008000000001
12400000000008000800008000000001
11111111111111111111111111111111