11111111111111111111111111111111
10004000000000000000000000000001
10004000000000000000004000458801
11004008888800000000004608401111
11104001111100000000004111400001
10004000000000400004111100000001
10004000000000400004000000000001
10004000000000407004030003080051
10004000000000401111111111111111
10004000000000400000000000001111
16004000000000400000000000001111
11104080030800400000000000000001
10004111111110400000000000040001
10004000000000400000000000040701
10804050000000404000000000041111
11111110000080404000000000041101
10000000000011404000000040040001
10000000000000004400000040840501
10000000000000000400000041111111
10000000000000000400000040000001
10000000000000000400000040000001
10000000000000000400000040000001
10306300500700020400000043000001
11111111111111111111111111111111
